OOOOOOOOOO
OOOOOOOSSO
OOOOO  abO
OOOOO XSSO
OOOOOO  OO
OR     OOO
OO A X X O
OO BXO O O
OO   O   O
OOOOOOOOOO