OOOOOOOOOOO
Oa  O B  bO
O   O     O
O   OOO X O
O  O  OOSSO
OAX  XRX  O
O     O SOO
OOOOOOOOOOO